##########################
#     #          #       #
#  s  #    ###   #    f  #
#     #    #     #       #
#     #    #     ##     ##
#          #      #      #
#          #             #
##########################