###########################
# s   #     #           f #
#   ###     #####         #
#   #       #        ######
#   ###     #####    #    #
#                         #
###########################