##########################
#                #       #
#  s             #    f  #
#                #       #
#                #########
#                        #
#                        #
##########################